%%%%%%
%   o%
% % .%
%P   %
%%%%%%